code;municipal;zone;section;name;census;abstentions;v_cast;v_invalid;v_valid;v_white
1;ABAIGAR;1;1;U;77;19;58;0;58;2
2;ABARZUZA;1;1;U;452;227;225;1;224;0
3;ABAURREGAINA / ABAURREA ALTA;1;1;U;155;43;112;5;107;4
4;ABAURREPEA / ABAURREA BAJA;1;1;U;44;14;30;0;30;1
5;ABERIN;1;1;U;305;140;165;2;163;2
6;ABLITAS;1;1;U;505;122;383;2;381;5
6;ABLITAS;2;1;A;737;150;587;4;583;6
6;ABLITAS;2;1;B;702;124;578;3;575;18
7;ADIOS;1;1;U;114;27;87;2;85;0
8;AGUILAR DE CODES;1;1;U;99;43;56;0;56;0
9;AIBAR / OIBAR;1;1;A;406;130;276;0;276;8
9;AIBAR / OIBAR;1;1;B;381;108;273;2;271;3
10;ALTSASU / ALSASUA;1;1;A;709;230;479;1;478;12
10;ALTSASU / ALSASUA;1;1;B;711;249;462;4;458;5
10;ALTSASU / ALSASUA;1;2;A;475;178;297;3;294;9
10;ALTSASU / ALSASUA;1;2;B;515;198;317;11;306;8
10;ALTSASU / ALSASUA;2;1;A;521;180;341;5;336;9
10;ALTSASU / ALSASUA;2;1;B;526;154;372;9;363;9
10;ALTSASU / ALSASUA;2;2;A;523;185;338;9;329;1
10;ALTSASU / ALSASUA;2;2;B;531;201;330;9;321;6
10;ALTSASU / ALSASUA;2;2;C;517;197;320;8;312;7
10;ALTSASU / ALSASUA;2;3;U;779;336;443;10;433;4
11;ALLIN;1;1;A;371;151;220;0;220;6
11;ALLIN;1;1;B;368;129;239;1;238;6
12;ALLO;1;1;A;458;118;340;7;333;6
12;ALLO;1;1;B;478;109;369;3;366;7
13;AMESCOA BAJA;1;1;A;361;171;190;4;186;6
13;AMESCOA BAJA;1;1;B;365;186;179;3;176;4
14;ANCIN;1;1;U;261;103;158;0;158;3
15;ANDOSILLA;1;1;A;423;117;306;1;305;6
15;ANDOSILLA;1;1;B;494;154;340;6;334;5
15;ANDOSILLA;2;1;A;578;185;393;5;388;9
15;ANDOSILLA;2;1;B;597;133;464;1;463;18
16;ANSOAIN;1;1;A;756;325;431;1;430;8
16;ANSOAIN;1;1;B;823;367;456;2;454;10
16;ANSOAIN;1;2;A;770;314;456;6;450;11
16;ANSOAIN;1;2;B;893;369;524;2;522;15
16;ANSOAIN;1;3;A;1135;484;651;7;644;20
16;ANSOAIN;1;3;B;1124;466;658;8;650;23
17;ANUE;1;1;U;374;145;229;0;229;6
18;AÑORBE;1;1;U;390;68;322;2;320;8
19;AOIZ / AGOITZ;1;1;U;631;117;514;9;505;29
19;AOIZ / AGOITZ;2;1;U;927;180;747;7;740;17
20;ARAITZ;1;1;U;552;187;365;9;356;8
21;ARANARACHE;1;1;U;89;31;58;0;58;3
22;ARANTZA;1;1;U;611;122;489;5;484;12
23;ARANGUREN;1;1;A;735;194;541;3;538;15
23;ARANGUREN;1;1;B;725;209;516;6;510;21
23;ARANGUREN;1;2;A;846;220;626;8;618;23
23;ARANGUREN;1;2;B;258;69;189;0;189;7
24;ARANO;1;1;U;142;63;79;0;79;2
25;ARAKIL;1;1;A;323;86;237;3;234;10
25;ARAKIL;1;1;B;418;170;248;1;247;3
26;ARAS;1;1;U;217;66;151;3;148;0
27;ARBIZU;1;1;U;745;109;636;3;633;5
28;ARCE / ARTZI;1;1;U;264;78;186;3;183;5
29;ARCOS (LOS);1;1;A;638;157;481;8;473;7
29;ARCOS (LOS);1;1;B;527;133;394;7;387;7
30;ARELLANO;1;1;U;182;66;116;0;116;4
31;ARESO;1;1;U;256;24;232;4;228;5
32;ARGUEDAS;1;1;A;622;127;495;0;495;11
32;ARGUEDAS;1;1;B;691;132;559;3;556;12
32;ARGUEDAS;2;1;U;573;120;453;5;448;6
33;ARIA;1;1;U;57;27;30;0;30;1
34;ARIBE;1;1;U;56;20;36;0;36;2
35;ARMAÑANZAS;1;1;U;93;27;66;2;64;1
36;ARRONIZ;1;1;A;565;185;380;4;376;8
36;ARRONIZ;1;1;B;459;127;332;7;325;10
37;ARRUAZU;1;1;U;95;26;69;0;69;0
38;ARTAJONA;1;1;A;713;180;533;8;525;16
38;ARTAJONA;1;1;B;703;160;543;3;540;22
39;ARTAZU;1;1;U;87;33;54;2;52;2
40;ATEZ;1;1;U;196;44;152;1;151;1
41;AYEGUI;1;1;U;768;227;541;0;541;18
42;AZAGRA;1;1;A;652;119;533;10;523;12
42;AZAGRA;1;1;B;762;122;640;15;625;6
42;AZAGRA;2;1;A;461;85;376;7;369;7
42;AZAGRA;2;1;B;478;89;389;8;381;13
42;AZAGRA;2;1;C;486;107;379;4;375;9
43;AZUELO;1;1;U;58;13;45;0;45;4
44;BAKAIKU;1;1;U;306;53;253;1;252;2
45;BARASOAIN;1;1;U;381;109;272;0;272;2
46;BARBARIN;1;1;U;92;25;67;2;65;3
47;BARGOTA;1;1;U;356;129;227;0;227;4
48;BARILLAS;1;1;U;173;31;142;2;140;4
49;BASABURUA;1;1;U;607;147;460;4;456;5
50;BAZTAN;1;1;A;432;125;307;3;304;2
50;BAZTAN;1;1;B;545;156;389;0;389;4
50;BAZTAN;1;1;C;397;114;283;2;281;0
50;BAZTAN;2;1;A;601;188;413;1;412;5
50;BAZTAN;2;1;B;519;156;363;2;361;6
50;BAZTAN;2;1;C;663;207;456;2;454;2
50;BAZTAN;2;2;A;498;156;342;1;341;9
50;BAZTAN;2;2;B;572;184;388;2;386;13
50;BAZTAN;2;2;C;492;130;362;1;361;4
50;BAZTAN;3;1;A;696;202;494;6;488;9
50;BAZTAN;3;1;B;595;167;428;9;419;7
50;BAZTAN;3;2;A;236;62;174;2;172;2
50;BAZTAN;3;2;B;270;99;171;1;170;3
51;BEIRE;1;1;U;277;89;188;1;187;1
52;BELASCOAIN;1;1;U;87;23;64;0;64;1
53;BERBINZANA;1;1;U;620;130;490;4;486;9
54;BERTIZARANA;1;1;U;537;119;418;9;409;18
55;BETELU;1;1;U;305;29;276;0;276;17
56;BIURRUN-OLCOZ;1;1;U;161;51;110;0;110;8
57;BUÑUEL;1;1;A;512;91;421;7;414;8
57;BUÑUEL;1;1;B;508;96;412;7;405;9
57;BUÑUEL;2;1;A;469;74;395;3;392;8
57;BUÑUEL;2;1;B;496;94;402;8;394;2
58;AURITZ / BURGUETE;1;1;U;282;38;244;2;242;9
59;BURGUI;1;1;U;209;80;129;1;128;1
60;BURLADA / BURLATA;1;1;B;694;317;377;4;373;14
60;BURLADA / BURLATA;1;1;C;555;233;322;0;322;12
60;BURLADA / BURLATA;1;1;A;609;282;327;1;326;14
60;BURLADA / BURLATA;1;2;A;562;257;305;2;303;11
60;BURLADA / BURLATA;1;2;B;596;249;347;0;347;8
60;BURLADA / BURLATA;1;3;A;508;235;273;1;272;4
60;BURLADA / BURLATA;1;3;B;526;261;265;1;264;7
60;BURLADA / BURLATA;1;4;A;610;263;347;1;346;4
60;BURLADA / BURLATA;1;4;B;644;298;346;5;341;8
60;BURLADA / BURLATA;1;5;A;717;298;419;1;418;12
60;BURLADA / BURLATA;1;5;B;734;333;401;3;398;10
60;BURLADA / BURLATA;2;1;A;611;282;329;2;327;4
60;BURLADA / BURLATA;2;1;B;638;306;332;4;328;8
60;BURLADA / BURLATA;2;2;A;539;243;296;5;291;7
60;BURLADA / BURLATA;2;2;B;547;261;286;5;281;7
60;BURLADA / BURLATA;2;3;A;456;204;252;2;250;2
60;BURLADA / BURLATA;2;3;B;444;185;259;2;257;10
60;BURLADA / BURLATA;2;4;A;680;304;376;0;376;9
60;BURLADA / BURLATA;2;4;B;650;264;386;0;386;15
60;BURLADA / BURLATA;2;5;A;672;261;411;2;409;7
60;BURLADA / BURLATA;2;5;B;702;264;438;9;429;25
60;BURLADA / BURLATA;2;6;A;443;217;226;1;225;6
60;BURLADA / BURLATA;2;6;B;460;193;267;1;266;3
61;BUSTO (EL);1;1;U;92;20;72;0;72;0
62;CABANILLAS;1;1;A;608;59;549;0;549;9
62;CABANILLAS;1;1;B;590;62;528;2;526;8
63;CABREDO;1;1;U;127;36;91;1;90;2
64;CADREITA;1;1;C;588;92;496;3;493;9
64;CADREITA;1;1;A;537;68;469;5;464;7
64;CADREITA;1;1;B;410;58;352;8;344;7
65;CAPARROSO;1;1;U;717;106;611;2;609;3
65;CAPARROSO;2;1;A;604;63;541;6;535;14
65;CAPARROSO;2;1;B;634;92;542;4;538;10
66;CARCAR;1;1;A;513;76;437;8;429;13
66;CARCAR;1;1;B;565;62;503;3;500;11
67;CARCASTILLO;1;1;A;457;100;357;8;349;14
67;CARCASTILLO;1;1;B;401;90;311;6;305;9
67;CARCASTILLO;1;1;C;311;39;272;3;269;11
67;CARCASTILLO;2;1;A;519;124;395;5;390;17
67;CARCASTILLO;2;1;B;454;101;353;9;344;7
68;CASCANTE;1;1;A;552;106;446;4;442;8
68;CASCANTE;1;1;B;593;141;452;3;449;5
68;CASCANTE;2;1;A;653;141;512;11;501;6
68;CASCANTE;2;1;B;560;116;444;10;434;9
68;CASCANTE;2;1;C;714;138;576;2;574;6
69;CASEDA;1;1;A;469;69;400;4;396;10
69;CASEDA;1;1;B;377;53;324;7;317;8
69;CASEDA;1;1;C;40;6;34;0;34;2
70;CASTEJON;1;1;A;718;186;532;11;521;13
70;CASTEJON;1;1;B;702;162;540;4;536;14
70;CASTEJON;1;2;U;820;212;608;6;602;5
70;CASTEJON;2;1;U;486;135;351;6;345;10
71;CASTILLO-NUEVO;1;1;U;27;5;22;0;22;0
72;CINTRUENIGO;1;1;A;640;164;476;4;472;14
72;CINTRUENIGO;1;1;B;584;151;433;2;431;10
72;CINTRUENIGO;2;1;C;564;143;421;3;418;6
72;CINTRUENIGO;2;1;A;541;127;414;3;411;5
72;CINTRUENIGO;2;1;B;798;165;633;5;628;12
72;CINTRUENIGO;2;2;A;784;193;591;3;588;10
72;CINTRUENIGO;2;2;B;762;165;597;3;594;8
73;ZIORDIA;1;1;U;333;111;222;1;221;5
74;CIRAUQUI;1;1;U;416;93;323;5;318;8
75;CIRIZA;1;1;U;61;16;45;0;45;1
76;CIZUR;1;1;A;592;107;485;4;481;12
76;CIZUR;1;1;B;417;100;317;0;317;11
77;CORELLA;1;1;A;761;143;618;5;613;6
77;CORELLA;1;1;B;736;164;572;10;562;6
77;CORELLA;1;2;A;565;104;461;1;460;2
77;CORELLA;1;2;B;559;94;465;3;462;3
77;CORELLA;1;2;C;720;146;574;2;572;6
77;CORELLA;2;1;A;394;85;309;0;309;1
77;CORELLA;2;1;B;405;107;298;2;296;3
77;CORELLA;2;2;A;667;181;486;4;482;0
77;CORELLA;2;2;B;677;149;528;4;524;6
78;CORTES;1;1;A;541;130;411;6;405;13
78;CORTES;1;1;B;587;108;479;12;467;15
78;CORTES;2;1;A;773;172;601;10;591;12
78;CORTES;2;1;B;805;156;649;15;634;25
79;DESOJO;1;1;U;130;31;99;0;99;1
80;DICASTILLO;1;1;U;620;170;450;2;448;13
81;DONAMARIA;1;1;U;311;26;285;2;283;8
82;ETXALAR;1;1;U;666;174;492;3;489;29
83;ECHARRI;1;1;U;47;15;32;0;32;2
84;ETXARRI-ARANATZ;1;1;A;514;133;381;2;379;5
84;ETXARRI-ARANATZ;1;1;B;395;100;295;2;293;6
84;ETXARRI-ARANATZ;1;1;C;29;7;22;0;22;0
84;ETXARRI-ARANATZ;2;1;A;480;132;348;0;348;2
84;ETXARRI-ARANATZ;2;1;B;475;103;372;10;362;4
85;ETXAURI;1;1;U;360;46;314;5;309;14
86;EGUES;1;1;A;496;131;365;0;365;4
86;EGUES;1;1;B;1018;275;743;2;741;19
87;ELGORRIAGA;1;1;U;171;27;144;3;141;1
88;NOAIN (VALLE DE ELORZ) / NOAIN;1;1;A;432;136;296;2;294;15
88;NOAIN (VALLE DE ELORZ) / NOAIN;1;1;B;549;226;323;4;319;15
88;NOAIN (VALLE DE ELORZ) / NOAIN;1;1;C;501;215;286;3;283;6
88;NOAIN (VALLE DE ELORZ) / NOAIN;1;2;A;521;209;312;4;308;15
88;NOAIN (VALLE DE ELORZ) / NOAIN;1;2;B;580;207;373;8;365;11
88;NOAIN (VALLE DE ELORZ) / NOAIN;1;2;C;548;189;359;5;354;10
89;ENERIZ;1;1;U;168;31;137;4;133;2
90;ERATSUN;1;1;U;162;43;119;0;119;4
91;ERGOIEN;1;1;U;439;164;275;1;274;5
92;ERRO;1;1;A;261;80;181;1;180;5
92;ERRO;1;1;B;443;125;318;4;314;7
93;EZCAROZ;1;1;U;322;132;190;2;188;4
94;ESLAVA;1;1;U;166;52;114;0;114;5
95;ESPARZA;1;1;U;116;16;100;1;99;1
96;ESPRONCEDA;1;1;U;165;16;149;1;148;11
97;ESTELLA / LIZARRA;1;1;A;413;138;275;3;272;11
97;ESTELLA / LIZARRA;1;1;B;449;165;284;3;281;12
97;ESTELLA / LIZARRA;1;2;A;604;258;346;0;346;8
97;ESTELLA / LIZARRA;1;2;B;587;242;345;10;335;6
97;ESTELLA / LIZARRA;2;1;A;398;186;212;5;207;9
97;ESTELLA / LIZARRA;2;1;B;441;195;246;4;242;5
97;ESTELLA / LIZARRA;2;2;A;533;194;339;4;335;6
97;ESTELLA / LIZARRA;2;2;B;568;222;346;2;344;7
97;ESTELLA / LIZARRA;2;3;A;455;145;310;4;306;2
97;ESTELLA / LIZARRA;2;3;B;454;142;312;2;310;5
97;ESTELLA / LIZARRA;2;4;A;489;159;330;0;330;13
97;ESTELLA / LIZARRA;2;4;B;570;216;354;6;348;11
97;ESTELLA / LIZARRA;2;4;C;489;166;323;1;322;13
97;ESTELLA / LIZARRA;2;5;A;533;165;368;4;364;7
97;ESTELLA / LIZARRA;2;5;B;552;171;381;2;379;6
97;ESTELLA / LIZARRA;2;6;A;516;138;378;4;374;9
97;ESTELLA / LIZARRA;2;6;B;555;150;405;1;404;6
97;ESTELLA / LIZARRA;2;6;C;551;176;375;4;371;4
97;ESTELLA / LIZARRA;2;7;A;403;127;276;1;275;4
97;ESTELLA / LIZARRA;2;7;B;404;123;281;2;279;7
97;ESTELLA / LIZARRA;3;1;U;707;262;445;3;442;9
98;ESTERIBAR;1;1;A;482;167;315;16;299;9
98;ESTERIBAR;1;1;B;462;143;319;5;314;11
98;ESTERIBAR;1;1;C;342;121;221;0;221;5
99;ETAYO;1;1;U;87;8;79;0;79;3
100;EULATE;1;1;U;339;153;186;2;184;4
101;EZCABARTE;1;1;A;518;233;285;5;280;4
101;EZCABARTE;1;1;B;460;160;300;1;299;15
102;EZKURRA;1;1;U;216;112;104;0;104;1
103;EZPROGUI;1;1;U;55;16;39;0;39;3
104;FALCES;1;1;A;519;113;406;9;397;10
104;FALCES;1;1;B;517;118;399;7;392;7
104;FALCES;2;1;A;642;182;460;4;456;9
104;FALCES;2;1;B;552;132;420;4;416;6
105;FITERO;1;1;U;759;92;667;3;664;8
105;FITERO;2;1;A;516;65;451;6;445;4
105;FITERO;2;1;B;525;83;442;6;436;4
106;FONTELLAS;1;1;U;577;84;493;2;491;11
107;FUNES;1;1;A;406;43;363;3;360;4
107;FUNES;1;1;B;370;54;316;3;313;6
107;FUNES;2;1;A;500;74;426;2;424;9
107;FUNES;2;1;B;474;77;397;5;392;4
108;FUSTIÑANA;1;1;A;521;94;427;4;423;13
108;FUSTIÑANA;1;1;B;471;97;374;2;372;12
108;FUSTIÑANA;2;1;A;533;115;418;3;415;12
108;FUSTIÑANA;2;1;B;407;72;335;5;330;7
109;GALAR;1;1;A;416;119;297;5;292;6
109;GALAR;1;1;B;560;199;361;1;360;9
110;GALLIPIENZO;1;1;U;161;72;89;0;89;4
111;GALLUES;1;1;U;114;31;83;0;83;3
112;GARAIOA;1;1;U;118;34;84;0;84;0
113;GARDE;1;1;U;191;87;104;0;104;2
114;GARINOAIN;1;1;U;279;63;216;3;213;1
115;GARRALDA;1;1;U;200;67;133;0;133;3
116;GENEVILLA;1;1;U;119;20;99;0;99;5
117;GOIZUETA;1;1;A;375;101;274;5;269;9
117;GOIZUETA;1;1;B;424;140;284;7;277;4
118;GOÑI;1;1;U;186;76;110;2;108;1
119;GUESA;1;1;U;76;25;51;0;51;3
120;GUESALAZ;1;1;U;428;147;281;0;281;13
121;GUIRGUILLANO;1;1;U;79;16;63;1;62;4
122;HUARTE / UHARTE;1;1;A;588;164;424;6;418;11
122;HUARTE / UHARTE;1;1;B;585;168;417;3;414;5
122;HUARTE / UHARTE;1;2;A;573;182;391;2;389;15
122;HUARTE / UHARTE;1;2;B;556;195;361;1;360;5
123;UHARTE-ARAKIL;1;1;U;624;309;315;2;313;4
124;IBARGOITI;1;1;U;215;51;164;1;163;5
125;IGUZQUIZA;1;1;U;298;107;191;0;191;5
126;IMOTZ;1;1;U;370;115;255;0;255;2
127;IRAÑETA;1;1;U;129;35;94;0;94;3
128;ISABA / IZABA;1;1;U;468;116;352;1;351;12
129;ITUREN;1;1;U;384;62;322;4;318;4
130;ITURMENDI;1;1;U;316;105;211;1;210;3
131;IZA;1;1;A;227;75;152;2;150;7
131;IZA;1;1;B;379;139;240;6;234;7
132;IZAGAONDOA;1;1;U;152;47;105;2;103;7
133;IZALZU;1;1;U;46;11;35;0;35;0
134;JAURRIETA;1;1;U;244;100;144;0;144;2
135;JAVIER;1;1;U;115;115;0;0;0;0
136;JUSLAPEÑA;1;1;A;179;77;102;2;100;2
136;JUSLAPEÑA;1;1;B;235;116;119;0;119;7
137;LABAIEN;1;1;U;247;108;139;1;138;2
138;LAKUNTZA;1;1;U;826;119;707;2;705;23
139;LANA;1;1;U;199;94;105;0;105;1
140;LANTZ;1;1;U;112;36;76;0;76;2
141;LAPOBLACION;1;1;U;188;68;120;1;119;5
142;LARRAGA;1;1;A;603;213;390;2;388;5
142;LARRAGA;1;1;B;418;146;272;2;270;6
142;LARRAGA;1;1;C;559;208;351;2;349;11
143;LARRAONA;1;1;U;148;61;87;0;87;4
144;LARRAUN;1;1;A;304;71;233;0;233;4
144;LARRAUN;1;1;B;394;150;244;0;244;4
144;LARRAUN;1;1;C;325;56;269;7;262;3
145;LAZAGURRIA;1;1;U;207;65;142;2;140;2
146;LEACHE;1;1;U;48;12;36;0;36;0
147;LEGARDA;1;1;U;69;15;54;0;54;3
148;LEGARIA;1;1;U;121;46;75;1;74;1
149;LEITZA;1;1;A;615;147;468;6;462;8
149;LEITZA;1;1;B;611;147;464;5;459;8
149;LEITZA;1;2;A;647;168;479;5;474;5
149;LEITZA;1;2;B;650;194;456;7;449;5
150;LEOZ;1;1;U;246;59;187;1;186;7
151;LERGA;1;1;U;92;25;67;2;65;1
152;LERIN;1;1;A;362;135;227;1;226;3
152;LERIN;1;1;B;434;156;278;5;273;9
152;LERIN;2;1;A;458;176;282;2;280;13
152;LERIN;2;1;B;420;161;259;4;255;4
153;LESAKA;1;1;A;507;149;358;2;356;7
153;LESAKA;1;1;B;492;143;349;4;345;11
153;LESAKA;2;1;A;593;166;427;8;419;13
153;LESAKA;2;1;B;743;227;516;7;509;8
154;LEZAUN;1;1;U;255;118;137;5;132;7
155;LIEDENA;1;1;U;289;82;207;2;205;3
156;LIZOAIN;1;1;U;207;37;170;1;169;4
157;LODOSA;1;1;A;587;183;404;6;398;9
157;LODOSA;1;1;B;533;172;361;5;356;9
157;LODOSA;1;2;A;687;166;521;6;515;10
157;LODOSA;1;2;B;697;180;517;2;515;8
157;LODOSA;2;1;A;612;198;414;3;411;12
157;LODOSA;2;1;B;636;195;441;3;438;6
158;LONGUIDA;1;1;U;274;58;216;1;215;11
159;LUMBIER;1;1;A;654;110;544;11;533;8
159;LUMBIER;1;1;B;579;124;455;5;450;9
160;LUQUIN;1;1;U;117;29;88;0;88;3
161;MAÑERU;1;1;U;308;118;190;0;190;3
162;MARAÑON;1;1;U;70;25;45;1;44;2
163;MARCILLA;1;1;U;838;218;620;3;617;8
163;MARCILLA;2;1;A;587;128;459;3;456;3
163;MARCILLA;2;1;B;597;121;476;3;473;7
164;MELIDA;1;1;A;412;78;334;2;332;7
164;MELIDA;1;1;B;330;55;275;8;267;3
165;MENDAVIA;1;1;B;390;90;300;6;294;4
165;MENDAVIA;1;1;A;490;123;367;5;362;18
165;MENDAVIA;1;1;C;547;127;420;8;412;9
165;MENDAVIA;2;1;A;541;115;426;1;425;19
165;MENDAVIA;2;1;B;471;116;355;6;349;12
165;MENDAVIA;2;1;C;593;128;465;5;460;17
166;MENDAZA;1;1;U;343;168;175;0;175;2
167;MENDIGORRIA;1;1;U;764;136;628;4;624;19
168;METAUTEN;1;1;U;283;104;179;3;176;3
169;MILAGRO;1;1;A;437;93;344;2;342;3
169;MILAGRO;1;1;B;351;351;0;0;0;0
169;MILAGRO;2;1;A;611;73;538;4;534;3
169;MILAGRO;2;1;B;739;111;628;0;628;8
170;MIRAFUENTES;1;1;U;51;11;40;1;39;1
171;MIRANDA DE ARGA;1;1;A;433;56;377;6;371;14
171;MIRANDA DE ARGA;1;1;B;428;75;353;5;348;7
172;MONREAL;1;1;U;250;72;178;0;178;9
173;MONTEAGUDO;1;1;A;407;35;372;2;370;3
173;MONTEAGUDO;1;1;B;592;51;541;9;532;10
174;MORENTIN;1;1;U;108;52;56;0;56;2
175;MUES;1;1;U;113;35;78;1;77;2
176;MURCHANTE;1;1;A;816;214;602;6;596;12
176;MURCHANTE;1;1;B;810;214;596;10;586;13
176;MURCHANTE;2;1;U;903;236;667;15;652;17
177;MURIETA;1;1;U;250;97;153;0;153;3
178;MURILLO EL CUENDE;1;1;A;72;23;49;0;49;0
178;MURILLO EL CUENDE;1;1;B;424;111;313;3;310;9
178;MURILLO EL CUENDE;1;1;C;67;9;58;1;57;2
179;MURILLO EL FRUTO;1;1;U;667;102;565;8;557;17
180;MURUZABAL;1;1;U;217;60;157;0;157;4
181;NAVASCUES;1;1;U;200;52;148;2;146;5
182;NAZAR;1;1;U;52;20;32;0;32;0
183;OBANOS;1;1;U;614;89;525;1;524;11
184;OCO;1;1;U;78;29;49;0;49;0
185;OCHAGAVIA;1;1;U;626;101;525;5;520;15
186;ODIETA;1;1;U;268;120;148;1;147;4
187;OITZ;1;1;U;126;45;81;2;79;1
188;OLAIBAR;1;1;U;148;59;89;1;88;4
189;OLAZTI / OLAZAGUTIA;1;1;A;425;124;301;4;297;9
189;OLAZTI / OLAZAGUTIA;1;1;B;455;131;324;4;320;16
189;OLAZTI / OLAZAGUTIA;1;1;C;521;170;351;6;345;15
190;OLEJUA;1;1;U;50;17;33;0;33;1
191;OLITE;1;1;A;791;185;606;6;600;9
191;OLITE;1;1;B;756;196;560;3;557;9
191;OLITE;2;1;A;479;113;366;2;364;8
191;OLITE;2;1;B;519;144;375;2;373;4
192;OLORIZ;1;1;U;161;45;116;1;115;2
193;OLZA;1;1;A;270;60;210;7;203;14
193;OLZA;1;1;B;447;119;328;3;325;8
193;OLZA;1;1;C;376;88;288;3;285;11
194;OLLO;1;1;U;352;102;250;1;249;12
195;ORBAITZETA;1;1;U;211;73;138;1;137;4
196;ORBARA;1;1;U;56;11;45;0;45;2
197;ORISOAIN;1;1;U;87;37;50;0;50;2
198;ORONZ;1;1;U;47;15;32;0;32;1
199;OROZ-BETELU;1;1;U;213;78;135;5;130;3
200;OTEIZA;1;1;U;797;193;604;11;593;22
201;PAMPLONA / IRUÑA;1;1;U;769;304;465;5;460;4
201;PAMPLONA / IRUÑA;1;2;U;579;199;380;1;379;6
201;PAMPLONA / IRUÑA;1;3;U;727;286;441;1;440;7
201;PAMPLONA / IRUÑA;1;4;A;401;137;264;1;263;10
201;PAMPLONA / IRUÑA;1;4;B;385;138;247;4;243;5
201;PAMPLONA / IRUÑA;1;5;B;478;189;289;7;282;5
201;PAMPLONA / IRUÑA;1;5;A;454;170;284;3;281;4
201;PAMPLONA / IRUÑA;1;6;U;666;239;427;2;425;9
201;PAMPLONA / IRUÑA;1;7;U;639;248;391;0;391;4
201;PAMPLONA / IRUÑA;1;8;U;751;315;436;4;432;9
201;PAMPLONA / IRUÑA;1;9;A;463;151;312;2;310;8
201;PAMPLONA / IRUÑA;1;9;B;387;138;249;1;248;0
201;PAMPLONA / IRUÑA;1;10;A;412;130;282;2;280;6
201;PAMPLONA / IRUÑA;1;10;B;458;154;304;1;303;6
201;PAMPLONA / IRUÑA;1;11;A;398;181;217;2;215;2
201;PAMPLONA / IRUÑA;1;11;B;393;167;226;1;225;3
201;PAMPLONA / IRUÑA;1;12;U;696;335;361;2;359;3
201;PAMPLONA / IRUÑA;1;13;A;471;172;299;1;298;1
201;PAMPLONA / IRUÑA;1;13;B;515;214;301;1;300;2
201;PAMPLONA / IRUÑA;2;1;A;563;204;359;3;356;8
201;PAMPLONA / IRUÑA;2;1;B;549;194;355;2;353;11
201;PAMPLONA / IRUÑA;2;2;A;460;130;330;0;330;8
201;PAMPLONA / IRUÑA;2;2;B;436;136;300;1;299;3
201;PAMPLONA / IRUÑA;2;3;B;542;174;368;1;367;5
201;PAMPLONA / IRUÑA;2;3;A;343;84;259;0;259;3
201;PAMPLONA / IRUÑA;2;4;A;640;198;442;3;439;10
201;PAMPLONA / IRUÑA;2;4;B;577;182;395;0;395;6
201;PAMPLONA / IRUÑA;2;4;C;581;204;377;0;377;8
201;PAMPLONA / IRUÑA;2;5;B;588;163;425;5;420;8
201;PAMPLONA / IRUÑA;2;5;C;516;141;375;2;373;11
201;PAMPLONA / IRUÑA;2;5;A;460;120;340;0;340;12
201;PAMPLONA / IRUÑA;2;6;B;580;190;390;1;389;7
201;PAMPLONA / IRUÑA;2;6;A;619;207;412;0;412;12
201;PAMPLONA / IRUÑA;2;7;A;461;140;321;1;320;10
201;PAMPLONA / IRUÑA;2;7;B;504;161;343;1;342;8
201;PAMPLONA / IRUÑA;2;8;A;566;183;383;5;378;8
201;PAMPLONA / IRUÑA;2;8;B;568;174;394;4;390;6
201;PAMPLONA / IRUÑA;2;9;A;585;207;378;3;375;10
201;PAMPLONA / IRUÑA;2;9;B;539;215;324;2;322;3
201;PAMPLONA / IRUÑA;2;10;A;589;208;381;1;380;14
201;PAMPLONA / IRUÑA;2;10;B;589;189;400;3;397;14
201;PAMPLONA / IRUÑA;2;11;A;623;210;413;2;411;12
201;PAMPLONA / IRUÑA;2;11;B;612;195;417;1;416;11
201;PAMPLONA / IRUÑA;2;12;A;678;222;456;1;455;5
201;PAMPLONA / IRUÑA;2;12;B;651;204;447;2;445;16
201;PAMPLONA / IRUÑA;2;13;A;426;142;284;3;281;8
201;PAMPLONA / IRUÑA;2;13;B;397;119;278;1;277;8
201;PAMPLONA / IRUÑA;2;14;A;656;187;469;2;467;6
201;PAMPLONA / IRUÑA;2;14;B;592;179;413;3;410;14
201;PAMPLONA / IRUÑA;2;15;A;429;128;301;1;300;5
201;PAMPLONA / IRUÑA;2;15;B;462;153;309;1;308;10
201;PAMPLONA / IRUÑA;2;16;A;429;166;263;0;263;11
201;PAMPLONA / IRUÑA;2;16;B;414;149;265;0;265;12
201;PAMPLONA / IRUÑA;2;17;A;448;164;284;0;284;3
201;PAMPLONA / IRUÑA;2;17;B;379;124;255;4;251;4
201;PAMPLONA / IRUÑA;3;1;A;431;157;274;0;274;4
201;PAMPLONA / IRUÑA;3;1;B;445;168;277;0;277;5
201;PAMPLONA / IRUÑA;3;2;B;467;142;325;2;323;8
201;PAMPLONA / IRUÑA;3;2;A;450;160;290;1;289;10
201;PAMPLONA / IRUÑA;3;3;A;527;165;362;1;361;6
201;PAMPLONA / IRUÑA;3;3;B;642;213;429;1;428;7
201;PAMPLONA / IRUÑA;3;3;C;609;206;403;3;400;6
201;PAMPLONA / IRUÑA;3;4;A;410;161;249;2;247;3
201;PAMPLONA / IRUÑA;3;4;B;383;158;225;0;225;2
201;PAMPLONA / IRUÑA;3;5;A;517;204;313;1;312;9
201;PAMPLONA / IRUÑA;3;6;A;517;165;352;2;350;13
201;PAMPLONA / IRUÑA;3;6;B;552;163;389;2;387;7
201;PAMPLONA / IRUÑA;3;6;C;531;177;354;2;352;5
201;PAMPLONA / IRUÑA;3;7;A;602;151;451;1;450;16
201;PAMPLONA / IRUÑA;3;7;B;608;169;439;2;437;12
201;PAMPLONA / IRUÑA;3;8;A;430;189;241;0;241;4
201;PAMPLONA / IRUÑA;3;8;B;506;189;317;0;317;4
201;PAMPLONA / IRUÑA;3;8;C;432;169;263;0;263;0
201;PAMPLONA / IRUÑA;3;9;A;605;240;365;2;363;5
201;PAMPLONA / IRUÑA;3;9;B;552;218;334;1;333;11
201;PAMPLONA / IRUÑA;3;10;A;579;210;369;2;367;6
201;PAMPLONA / IRUÑA;3;10;B;618;237;381;5;376;10
201;PAMPLONA / IRUÑA;3;11;A;620;166;454;0;454;18
201;PAMPLONA / IRUÑA;3;11;B;555;142;413;3;410;21
201;PAMPLONA / IRUÑA;3;12;A;523;187;336;4;332;5
201;PAMPLONA / IRUÑA;3;12;B;539;187;352;2;350;11
201;PAMPLONA / IRUÑA;3;13;A;581;241;340;3;337;9
201;PAMPLONA / IRUÑA;3;13;B;588;226;362;1;361;7
201;PAMPLONA / IRUÑA;3;14;C;549;189;360;2;358;13
201;PAMPLONA / IRUÑA;3;14;A;550;182;368;0;368;7
201;PAMPLONA / IRUÑA;3;14;B;491;193;298;3;295;4
201;PAMPLONA / IRUÑA;3;15;A;522;158;364;2;362;7
201;PAMPLONA / IRUÑA;3;15;B;598;208;390;2;388;2
201;PAMPLONA / IRUÑA;3;15;C;564;205;359;2;357;11
201;PAMPLONA / IRUÑA;3;16;A;514;167;347;4;343;13
201;PAMPLONA / IRUÑA;3;16;B;532;185;347;2;345;8
201;PAMPLONA / IRUÑA;3;17;A;582;188;394;0;394;9
201;PAMPLONA / IRUÑA;3;17;B;564;157;407;2;405;12
201;PAMPLONA / IRUÑA;3;18;A;513;171;342;1;341;6
201;PAMPLONA / IRUÑA;3;18;B;578;198;380;4;376;12
201;PAMPLONA / IRUÑA;3;19;A;532;179;353;1;352;3
201;PAMPLONA / IRUÑA;3;19;B;648;224;424;4;420;8
201;PAMPLONA / IRUÑA;3;19;C;640;217;423;7;416;7
201;PAMPLONA / IRUÑA;3;20;A;766;265;501;0;501;14
201;PAMPLONA / IRUÑA;3;20;B;693;246;447;0;447;11
201;PAMPLONA / IRUÑA;3;21;A;610;176;434;3;431;8
201;PAMPLONA / IRUÑA;3;21;B;719;235;484;4;480;16
201;PAMPLONA / IRUÑA;3;22;A;400;150;250;0;250;9
201;PAMPLONA / IRUÑA;3;22;B;371;117;254;1;253;7
201;PAMPLONA / IRUÑA;3;23;B;713;220;493;4;489;9
201;PAMPLONA / IRUÑA;3;23;A;740;244;496;1;495;12
201;PAMPLONA / IRUÑA;3;24;A;677;226;451;3;448;8
201;PAMPLONA / IRUÑA;3;24;B;687;237;450;5;445;11
201;PAMPLONA / IRUÑA;3;25;A;816;305;511;7;504;15
201;PAMPLONA / IRUÑA;3;25;B;812;302;510;0;510;12
201;PAMPLONA / IRUÑA;3;26;A;662;303;359;1;358;11
201;PAMPLONA / IRUÑA;3;26;B;625;297;328;1;327;7
201;PAMPLONA / IRUÑA;3;27;A;466;177;289;1;288;12
201;PAMPLONA / IRUÑA;3;27;B;477;201;276;1;275;10
201;PAMPLONA / IRUÑA;4;1;B;661;292;369;0;369;5
201;PAMPLONA / IRUÑA;4;1;A;717;287;430;2;428;14
201;PAMPLONA / IRUÑA;4;2;A;483;168;315;1;314;12
201;PAMPLONA / IRUÑA;4;2;B;620;209;411;4;407;7
201;PAMPLONA / IRUÑA;4;2;C;500;188;312;1;311;9
201;PAMPLONA / IRUÑA;4;3;A;674;255;419;3;416;8
201;PAMPLONA / IRUÑA;4;3;B;652;241;411;1;410;15
201;PAMPLONA / IRUÑA;4;4;A;529;165;364;0;364;15
201;PAMPLONA / IRUÑA;4;4;B;585;164;421;2;419;16
201;PAMPLONA / IRUÑA;4;5;A;573;167;406;1;405;9
201;PAMPLONA / IRUÑA;4;5;B;634;202;432;4;428;10
201;PAMPLONA / IRUÑA;4;6;A;474;122;352;0;352;10
201;PAMPLONA / IRUÑA;4;6;B;417;141;276;2;274;4
201;PAMPLONA / IRUÑA;4;7;A;604;200;404;2;402;9
201;PAMPLONA / IRUÑA;4;7;B;655;204;451;2;449;19
201;PAMPLONA / IRUÑA;4;8;A;738;200;538;2;536;15
201;PAMPLONA / IRUÑA;4;8;B;705;206;499;0;499;20
201;PAMPLONA / IRUÑA;4;9;A;561;219;342;0;342;8
201;PAMPLONA / IRUÑA;4;9;B;411;127;284;0;284;9
201;PAMPLONA / IRUÑA;4;10;A;716;215;501;3;498;18
201;PAMPLONA / IRUÑA;4;10;B;774;263;511;4;507;15
201;PAMPLONA / IRUÑA;4;11;A;641;269;372;2;370;7
201;PAMPLONA / IRUÑA;4;11;B;671;251;420;4;416;10
201;PAMPLONA / IRUÑA;4;12;A;514;266;248;2;246;5
201;PAMPLONA / IRUÑA;4;12;B;576;300;276;3;273;8
201;PAMPLONA / IRUÑA;4;13;A;650;296;354;1;353;3
201;PAMPLONA / IRUÑA;4;13;B;669;328;341;1;340;1
201;PAMPLONA / IRUÑA;4;14;A;594;170;424;2;422;12
201;PAMPLONA / IRUÑA;4;14;B;674;200;474;3;471;19
201;PAMPLONA / IRUÑA;4;15;U;698;237;461;1;460;8
201;PAMPLONA / IRUÑA;4;16;A;394;117;277;3;274;5
201;PAMPLONA / IRUÑA;4;16;B;465;138;327;2;325;12
201;PAMPLONA / IRUÑA;4;17;C;537;173;364;3;361;14
201;PAMPLONA / IRUÑA;4;17;A;588;182;406;1;405;15
201;PAMPLONA / IRUÑA;4;17;B;570;183;387;2;385;12
201;PAMPLONA / IRUÑA;4;18;A;574;194;380;1;379;8
201;PAMPLONA / IRUÑA;4;18;B;621;197;424;0;424;11
201;PAMPLONA / IRUÑA;4;18;C;529;175;354;2;352;7
201;PAMPLONA / IRUÑA;4;19;A;514;136;378;0;378;8
201;PAMPLONA / IRUÑA;4;19;B;509;157;352;1;351;10
201;PAMPLONA / IRUÑA;4;20;A;424;136;288;2;286;10
201;PAMPLONA / IRUÑA;4;20;B;437;123;314;3;311;8
201;PAMPLONA / IRUÑA;4;21;A;514;180;334;1;333;6
201;PAMPLONA / IRUÑA;4;21;B;544;190;354;1;353;11
201;PAMPLONA / IRUÑA;4;21;C;495;167;328;2;326;8
201;PAMPLONA / IRUÑA;4;22;A;478;165;313;2;311;6
201;PAMPLONA / IRUÑA;4;22;B;432;137;295;3;292;13
201;PAMPLONA / IRUÑA;4;23;U;541;156;385;0;385;16
201;PAMPLONA / IRUÑA;4;24;A;763;233;530;7;523;13
201;PAMPLONA / IRUÑA;4;24;B;744;208;536;3;533;13
201;PAMPLONA / IRUÑA;4;25;A;508;175;333;0;333;13
201;PAMPLONA / IRUÑA;4;25;B;577;218;359;3;356;10
201;PAMPLONA / IRUÑA;4;25;C;504;205;299;1;298;8
201;PAMPLONA / IRUÑA;4;26;A;560;259;301;3;298;4
201;PAMPLONA / IRUÑA;4;26;B;561;246;315;3;312;3
201;PAMPLONA / IRUÑA;5;1;A;488;190;298;0;298;1
201;PAMPLONA / IRUÑA;5;1;B;478;192;286;2;284;3
201;PAMPLONA / IRUÑA;5;2;A;503;186;317;1;316;2
201;PAMPLONA / IRUÑA;5;2;B;486;187;299;0;299;4
201;PAMPLONA / IRUÑA;5;3;U;677;264;413;5;408;8
201;PAMPLONA / IRUÑA;5;4;A;532;190;342;3;339;9
201;PAMPLONA / IRUÑA;5;4;B;512;202;310;2;308;9
201;PAMPLONA / IRUÑA;5;5;A;546;254;292;0;292;5
201;PAMPLONA / IRUÑA;5;5;B;509;196;313;4;309;3
201;PAMPLONA / IRUÑA;5;6;A;609;253;356;4;352;10
201;PAMPLONA / IRUÑA;5;6;B;572;217;355;8;347;9
201;PAMPLONA / IRUÑA;5;7;A;609;269;340;1;339;2
201;PAMPLONA / IRUÑA;5;7;B;639;290;349;1;348;8
201;PAMPLONA / IRUÑA;5;8;A;441;159;282;3;279;4
201;PAMPLONA / IRUÑA;5;8;B;453;174;279;1;278;3
201;PAMPLONA / IRUÑA;5;9;A;717;223;494;4;490;9
201;PAMPLONA / IRUÑA;5;9;B;684;264;420;2;418;12
201;PAMPLONA / IRUÑA;5;10;A;614;204;410;3;407;9
201;PAMPLONA / IRUÑA;5;10;B;639;228;411;1;410;13
201;PAMPLONA / IRUÑA;5;11;A;636;271;365;0;365;6
201;PAMPLONA / IRUÑA;5;11;B;562;227;335;3;332;12
201;PAMPLONA / IRUÑA;5;12;A;454;194;260;4;256;5
201;PAMPLONA / IRUÑA;5;12;B;429;177;252;1;251;4
201;PAMPLONA / IRUÑA;6;1;A;537;255;282;1;281;8
201;PAMPLONA / IRUÑA;6;1;B;586;259;327;4;323;12
201;PAMPLONA / IRUÑA;6;2;A;610;298;312;4;308;6
201;PAMPLONA / IRUÑA;6;2;B;669;336;333;1;332;11
201;PAMPLONA / IRUÑA;6;2;C;512;253;259;8;251;4
201;PAMPLONA / IRUÑA;6;3;A;575;219;356;1;355;5
201;PAMPLONA / IRUÑA;6;3;B;537;231;306;2;304;3
201;PAMPLONA / IRUÑA;6;4;A;478;188;290;2;288;3
201;PAMPLONA / IRUÑA;6;4;B;513;226;287;3;284;2
201;PAMPLONA / IRUÑA;6;5;A;639;267;372;1;371;7
201;PAMPLONA / IRUÑA;6;5;B;682;304;378;2;376;10
201;PAMPLONA / IRUÑA;6;6;A;401;168;233;0;233;3
201;PAMPLONA / IRUÑA;6;6;B;387;176;211;0;211;2
201;PAMPLONA / IRUÑA;6;7;A;482;174;308;3;305;4
201;PAMPLONA / IRUÑA;6;7;B;547;210;337;2;335;2
201;PAMPLONA / IRUÑA;6;7;C;542;219;323;2;321;8
201;PAMPLONA / IRUÑA;6;9;A;456;158;298;2;296;4
201;PAMPLONA / IRUÑA;6;9;B;459;163;296;4;292;4
201;PAMPLONA / IRUÑA;6;10;A;696;275;421;1;420;7
201;PAMPLONA / IRUÑA;6;10;B;617;216;401;0;401;5
201;PAMPLONA / IRUÑA;6;11;A;434;182;252;0;252;1
201;PAMPLONA / IRUÑA;6;11;B;427;165;262;1;261;7
201;PAMPLONA / IRUÑA;6;12;A;728;289;439;1;438;16
201;PAMPLONA / IRUÑA;6;12;B;775;301;474;3;471;17
201;PAMPLONA / IRUÑA;6;13;A;617;272;345;3;342;6
201;PAMPLONA / IRUÑA;6;13;B;615;268;347;0;347;6
201;PAMPLONA / IRUÑA;6;14;A;478;165;313;6;307;7
201;PAMPLONA / IRUÑA;6;14;B;512;194;318;3;315;8
201;PAMPLONA / IRUÑA;6;15;A;746;292;454;1;453;11
201;PAMPLONA / IRUÑA;6;15;B;728;283;445;4;441;21
201;PAMPLONA / IRUÑA;7;1;A;634;283;351;7;344;4
201;PAMPLONA / IRUÑA;7;1;B;674;295;379;3;376;5
201;PAMPLONA / IRUÑA;7;2;A;650;324;326;2;324;6
201;PAMPLONA / IRUÑA;7;2;B;565;259;306;5;301;4
201;PAMPLONA / IRUÑA;7;3;A;768;337;431;8;423;5
201;PAMPLONA / IRUÑA;7;3;B;760;333;427;1;426;10
201;PAMPLONA / IRUÑA;7;4;A;587;290;297;2;295;8
201;PAMPLONA / IRUÑA;7;4;B;617;299;318;0;318;5
201;PAMPLONA / IRUÑA;7;5;A;452;185;267;1;266;6
201;PAMPLONA / IRUÑA;7;5;B;509;219;290;2;288;7
201;PAMPLONA / IRUÑA;7;6;A;639;282;357;8;349;5
201;PAMPLONA / IRUÑA;7;6;B;703;324;379;3;376;5
201;PAMPLONA / IRUÑA;7;7;B;645;311;334;4;330;4
201;PAMPLONA / IRUÑA;7;7;C;546;268;278;3;275;4
201;PAMPLONA / IRUÑA;7;7;A;563;289;274;5;269;6
201;PAMPLONA / IRUÑA;7;8;B;645;285;360;1;359;4
201;PAMPLONA / IRUÑA;7;8;A;661;326;335;5;330;4
201;PAMPLONA / IRUÑA;7;9;A;581;341;240;1;239;2
201;PAMPLONA / IRUÑA;7;9;B;585;335;250;0;250;5
201;PAMPLONA / IRUÑA;7;10;A;396;197;199;2;197;5
201;PAMPLONA / IRUÑA;7;10;B;435;229;206;3;203;2
201;PAMPLONA / IRUÑA;7;11;C;539;237;302;4;298;11
201;PAMPLONA / IRUÑA;7;11;A;486;230;256;0;256;8
201;PAMPLONA / IRUÑA;7;11;B;632;293;339;4;335;11
201;PAMPLONA / IRUÑA;7;12;A;545;211;334;5;329;10
201;PAMPLONA / IRUÑA;7;12;B;626;274;352;1;351;13
201;PAMPLONA / IRUÑA;7;13;A;539;230;309;0;309;6
201;PAMPLONA / IRUÑA;7;13;B;558;242;316;2;314;7
201;PAMPLONA / IRUÑA;7;14;A;755;341;414;4;410;8
201;PAMPLONA / IRUÑA;7;14;B;752;348;404;2;402;4
201;PAMPLONA / IRUÑA;7;15;A;548;214;334;4;330;4
201;PAMPLONA / IRUÑA;7;15;B;566;208;358;2;356;9
201;PAMPLONA / IRUÑA;7;16;A;507;223;284;2;282;10
201;PAMPLONA / IRUÑA;7;16;B;519;220;299;1;298;2
201;PAMPLONA / IRUÑA;7;17;U;747;318;429;5;424;18
201;PAMPLONA / IRUÑA;7;18;A;629;264;365;1;364;8
201;PAMPLONA / IRUÑA;7;18;B;636;283;353;3;350;11
201;PAMPLONA / IRUÑA;7;19;A;582;239;343;2;341;2
201;PAMPLONA / IRUÑA;7;19;B;677;310;367;2;365;4
201;PAMPLONA / IRUÑA;8;1;A;494;215;279;2;277;10
201;PAMPLONA / IRUÑA;8;1;B;557;227;330;3;327;4
201;PAMPLONA / IRUÑA;8;2;A;522;199;323;0;323;11
201;PAMPLONA / IRUÑA;8;2;B;608;201;407;2;405;18
201;PAMPLONA / IRUÑA;8;2;C;551;232;319;4;315;3
201;PAMPLONA / IRUñA;8;3;A;547;216;331;2;329;10
201;PAMPLONA / IRUÑA;8;3;B;585;222;363;0;363;3
201;PAMPLONA / IRUÑA;8;3;C;558;219;339;1;338;12
201;PAMPLONA / IRUÑA;8;4;A;514;202;312;2;310;4
201;PAMPLONA / IRUÑA;8;4;B;485;176;309;1;308;8
201;PAMPLONA / IRUÑA;8;5;A;429;164;265;1;264;6
201;PAMPLONA / IRUÑA;8;5;B;462;201;261;2;259;5
202;PERALTA;1;1;A;513;136;377;3;374;6
202;PERALTA;1;1;B;540;133;407;8;399;7
202;PERALTA;1;2;A;754;167;587;6;581;13
202;PERALTA;1;2;B;599;141;458;0;458;13
202;PERALTA;2;1;A;730;162;568;3;565;18
202;PERALTA;2;1;B;720;164;556;4;552;21
203;PETILLA DE ARAGON;1;1;U;44;18;26;0;26;1
204;PIEDRAMILLERA;1;1;U;71;17;54;0;54;1
205;PITILLAS;1;1;U;511;123;388;3;385;11
206;PUENTE LA REINA / GARES;1;1;A;621;125;496;3;493;8
206;PUENTE LA REINA / GARES;1;1;B;677;139;538;4;534;14
206;PUENTE LA REINA / GARES;1;1;C;567;110;457;2;455;12
207;PUEYO;1;1;U;292;82;210;1;209;8
208;RIBAFORADA;1;1;A;360;73;287;2;285;2
208;RIBAFORADA;1;1;B;477;74;403;9;394;5
208;RIBAFORADA;2;1;A;563;115;448;6;442;6
208;RIBAFORADA;2;1;B;594;99;495;9;486;6
208;RIBAFORADA;2;1;C;587;83;504;7;497;5
209;ROMANZADO;1;1;U;144;46;98;0;98;0
210;RONCAL;1;1;U;311;49;262;1;261;18
211;ORREAGA / RONCESVALLES;1;1;U;27;4;23;0;23;0
212;SADA;1;1;U;226;98;128;1;127;1
213;SALDIAS;1;1;U;124;29;95;1;94;3
214;SALINAS DE ORO;1;1;U;94;33;61;1;60;1
215;SAN ADRIAN;1;1;A;595;175;420;5;415;14
215;SAN ADRIAN;1;1;B;525;127;398;0;398;13
215;SAN ADRIAN;1;2;A;639;175;464;0;464;8
215;SAN ADRIAN;1;2;B;574;574;0;0;0;0
215;SAN ADRIAN;2;1;A;661;192;469;1;468;15
215;SAN ADRIAN;2;1;B;651;166;485;1;484;11
215;SAN ADRIAN;2;2;U;746;185;561;8;553;9
216;SANGÜESA / ZANGOZA;1;1;A;694;214;480;0;480;8
216;SANGÜESA / ZANGOZA;1;1;B;748;204;544;4;540;17
216;SANGÜESA / ZANGOZA;2;1;A;430;100;330;2;328;6
216;SANGÜESA / ZANGOZA;2;1;B;439;104;335;1;334;4
216;SANGÜESA / ZANGOZA;2;2;A;768;220;548;3;545;13
216;SANGÜESA / ZANGOZA;2;2;B;796;257;539;2;537;9
217;SAN MARTIN DE UNX;1;1;U;460;153;307;4;303;10
219;SANSOL;1;1;U;118;38;80;0;80;2
220;SANTACARA;1;1;A;429;125;304;7;297;16
220;SANTACARA;1;1;B;464;133;331;7;324;7
221;DONEZTEBE / SANTESTEBAN;1;1;A;514;85;429;3;426;4
221;DONEZTEBE / SANTESTEBAN;1;1;B;521;115;406;6;400;7
222;SARRIES;1;1;U;74;24;50;0;50;2
223;SARTAGUDA;1;1;A;459;96;363;4;359;9
223;SARTAGUDA;1;1;B;725;138;587;1;586;20
224;SESMA;1;1;A;631;134;497;4;493;5
224;SESMA;1;1;B;587;127;460;2;458;14
225;SORLADA;1;1;U;47;15;32;0;32;1
226;SUNBILLA;1;1;U;572;144;428;11;417;7
227;TAFALLA;1;1;A;407;89;318;3;315;7
227;TAFALLA;1;1;B;409;102;307;1;306;4
227;TAFALLA;1;2;A;647;174;473;3;470;6
227;TAFALLA;1;2;B;768;175;593;7;586;13
227;TAFALLA;1;3;A;502;136;366;2;364;6
227;TAFALLA;1;3;B;599;168;431;5;426;6
227;TAFALLA;1;3;C;563;170;393;2;391;16
227;TAFALLA;2;1;A;628;203;425;1;424;16
227;TAFALLA;2;1;B;700;195;505;2;503;8
227;TAFALLA;2;1;C;601;147;454;2;452;9
227;TAFALLA;2;2;A;728;213;515;1;514;12
227;TAFALLA;2;2;B;725;226;499;3;496;12
227;TAFALLA;2;3;A;642;239;403;5;398;7
227;TAFALLA;2;3;B;605;217;388;2;386;4
228;TIEBAS-MURUARTE DE RETA;1;1;U;496;182;314;7;307;16
229;TIRAPU;1;1;U;60;13;47;0;47;1
230;TORRALBA DEL RIO;1;1;U;147;28;119;2;117;4
231;TORRES DEL RIO;1;1;U;179;54;125;2;123;4
232;TUDELA;1;1;A;591;229;362;4;358;8
232;TUDELA;1;1;B;508;173;335;2;333;13
232;TUDELA;1;2;A;510;168;342;9;333;18
232;TUDELA;1;2;B;483;131;352;6;346;14
232;TUDELA;1;3;U;504;169;335;4;331;5
232;TUDELA;2;1;A;861;295;566;14;552;15
232;TUDELA;2;1;B;959;341;618;11;607;15
232;TUDELA;2;2;A;553;176;377;2;375;9
232;TUDELA;2;2;B;552;189;363;1;362;8
232;TUDELA;2;3;A;525;167;358;5;353;15
232;TUDELA;2;3;B;627;192;435;9;426;17
232;TUDELA;2;4;U;924;311;613;1;612;23
232;TUDELA;2;5;U;647;202;445;3;442;9
232;TUDELA;3;1;A;711;248;463;6;457;7
232;TUDELA;3;1;B;729;226;503;6;497;10
232;TUDELA;3;2;A;827;253;574;9;565;24
232;TUDELA;3;2;B;710;203;507;8;499;19
232;TUDELA;3;3;A;610;187;423;6;417;21
232;TUDELA;3;3;B;687;243;444;7;437;9
232;TUDELA;3;4;A;562;203;359;3;356;5
232;TUDELA;3;4;B;697;217;480;4;476;10
232;TUDELA;3;4;C;566;183;383;1;382;11
232;TUDELA;3;5;A;610;237;373;4;369;7
232;TUDELA;3;5;B;716;229;487;4;483;23
232;TUDELA;3;6;U;832;283;549;13;536;15
232;TUDELA;4;1;U;785;244;541;1;540;11
232;TUDELA;4;2;B;576;179;397;6;391;12
232;TUDELA;4;2;C;512;147;365;2;363;5
232;TUDELA;4;2;A;520;177;343;5;338;2
232;TUDELA;4;3;A;483;155;328;4;324;8
232;TUDELA;4;3;B;573;180;393;3;390;8
232;TUDELA;4;3;C;542;147;395;8;387;11
232;TUDELA;4;4;A;617;216;401;2;399;16
232;TUDELA;4;4;B;682;239;443;10;433;12
232;TUDELA;4;5;U;958;330;628;6;622;18
233;TULEBRAS;1;1;U;96;16;80;0;80;2
234;UCAR;1;1;U;107;37;70;0;70;0
235;UJUE;1;1;U;231;83;148;1;147;4
236;ULTZAMA;1;1;A;690;249;441;4;437;15
236;ULTZAMA;1;1;B;642;226;416;0;416;22
237;UNCITI;1;1;U;205;62;143;0;143;3
238;UNZUE;1;1;U;125;28;97;0;97;2
239;URDAZUBI / URDAX;1;1;U;343;167;176;1;175;5
240;URDIAIN;1;1;U;578;255;323;2;321;1
241;URRAUL ALTO;1;1;U;152;54;98;2;96;3
242;URRAUL BAJO;1;1;U;259;102;157;0;157;7
243;URROZ;1;1;U;295;112;183;0;183;8
244;URROTZ;1;1;U;173;65;108;0;108;3
245;URZAINQUI;1;1;U;102;22;80;0;80;6
246;UTERGA;1;1;U;128;44;84;0;84;2
247;UZTARROZ / UZTARROZE;1;1;U;263;84;179;0;179;7
248;LUZAIDE / VALCARLOS;1;1;U;400;65;335;3;332;13
249;VALTIERRA;1;1;A;615;132;483;6;477;1
249;VALTIERRA;1;1;B;540;98;442;7;435;6
249;VALTIERRA;2;1;B;453;102;351;0;351;10
249;VALTIERRA;2;1;A;467;91;376;1;375;7
250;BERA / VERA DE BIDASOA;1;1;A;467;131;336;0;336;5
250;BERA / VERA DE BIDASOA;1;1;B;610;170;440;2;438;9
250;BERA / VERA DE BIDASOA;1;1;C;560;176;384;5;379;4
250;BERA / VERA DE BIDASOA;1;2;U;626;186;440;3;437;9
250;BERA / VERA DE BIDASOA;2;1;U;658;204;454;5;449;14
251;VIANA;1;1;A;709;162;547;4;543;12
251;VIANA;1;1;B;631;163;468;11;457;14
251;VIANA;1;2;U;945;222;723;6;717;16
251;VIANA;2;1;U;646;189;457;6;451;8
252;VIDANGOZ;1;1;U;102;38;64;0;64;0
253;BIDAURRETA;1;1;U;99;37;62;0;62;1
254;VILLAFRANCA;1;1;A;635;118;517;3;514;10
254;VILLAFRANCA;1;1;B;606;126;480;6;474;8
254;VILLAFRANCA;2;1;A;395;84;311;5;306;4
254;VILLAFRANCA;2;1;B;504;116;388;3;385;2
255;VILLAMAYOR DE MONJARDIN;1;1;U;100;22;78;0;78;8
256;HIRIBERRI/VILLANUEVA DE AEZKOA;1;1;U;145;92;53;1;52;0
257;VILLATUERTA;1;1;U;662;219;443;8;435;22
258;VILLAVA / ATARRABIA;1;1;A;584;210;374;2;372;11
258;VILLAVA / ATARRABIA;1;1;B;600;261;339;1;338;3
258;VILLAVA / ATARRABIA;2;1;A;679;225;454;2;452;8
258;VILLAVA / ATARRABIA;2;1;B;611;200;411;5;406;7
258;VILLAVA / ATARRABIA;2;2;A;897;309;588;3;585;9
258;VILLAVA / ATARRABIA;2;2;B;998;376;622;9;613;15
258;VILLAVA / ATARRABIA;2;3;A;702;234;468;2;466;17
258;VILLAVA / ATARRABIA;2;3;B;659;207;452;3;449;6
258;VILLAVA / ATARRABIA;2;4;A;705;224;481;3;478;9
258;VILLAVA / ATARRABIA;2;4;B;638;202;436;1;435;9
259;IGANTZI;1;1;U;508;85;423;3;420;11
260;YERRI;1;1;A;539;188;351;5;346;10
260;YERRI;1;1;B;376;155;221;0;221;2
260;YERRI;1;1;C;390;148;242;1;241;6
261;YESA;1;1;U;275;41;234;3;231;5
262;ZABALZA;1;1;U;136;36;100;0;100;3
263;ZUBIETA;1;1;U;288;114;174;7;167;11
264;ZUGARRAMURDI ;1;1;U;214;38;176;1;175;5
265;ZUÑIGA;1;1;U;114;22;92;0;92;3
899;C.E.R.A.;1;1;U;10485;9107;1378;3;1375;10
901;BARAÑAIN;1;1;A;664;288;376;4;372;6
901;BARAÑAIN;1;1;B;669;281;388;1;387;14
901;BARAÑAIN;1;2;A;688;285;403;1;402;4
901;BARAÑAIN;1;2;B;594;244;350;1;349;15
901;BARAÑAIN;1;3;A;737;312;425;2;423;14
901;BARAÑAIN;1;3;B;828;335;493;0;493;17
901;BARAÑAIN;1;4;A;894;350;544;3;541;20
901;BARAÑAIN;1;4;B;868;341;527;0;527;17
901;BARAÑAIN;1;5;A;847;358;489;4;485;10
901;BARAÑAIN;1;5;B;826;351;475;5;470;6
901;BARAÑAIN;1;6;A;766;353;413;1;412;8
901;BARAÑAIN;1;6;B;759;314;445;2;443;9
901;BARAÑAIN;1;7;A;860;329;531;1;530;13
901;BARAÑAIN;1;7;B;748;284;464;3;461;15
901;BARAÑAIN;1;8;A;752;324;428;2;426;16
901;BARAÑAIN;1;8;B;697;295;402;2;400;12
901;BARAÑAIN;1;9;U;823;371;452;2;450;7
901;BARAÑAIN;1;10;A;887;345;542;3;539;18
901;BARAÑAIN;1;10;B;856;364;492;0;492;15
901;BARAÑAIN;1;11;A;462;211;251;1;250;6
901;BARAÑAIN;1;11;B;448;172;276;2;274;6
902;BERRIOPLANO;1;1;A;455;121;334;1;333;13
902;BERRIOPLANO;1;1;B;487;133;354;1;353;10
903;BERRIOZAR;1;1;U;506;198;308;1;307;8
903;BERRIOZAR;1;2;A;670;263;407;2;405;11
903;BERRIOZAR;1;2;B;512;208;304;1;303;6
903;BERRIOZAR;1;3;A;535;213;322;1;321;3
903;BERRIOZAR;1;3;B;615;252;363;4;359;10
903;BERRIOZAR;1;4;A;840;358;482;2;480;7
903;BERRIOZAR;1;4;B;755;283;472;4;468;9
904;IRURTZUN;1;1;A;803;262;541;8;533;19
904;IRURTZUN;1;1;B;810;256;554;8;546;16
905;BERIAIN;1;1;A;656;216;440;6;434;5
905;BERIAIN;1;1;B;643;214;429;2;427;6
905;BERIAIN;1;2;U;740;280;460;0;460;15
906;ORCOYEN;1;1;A;568;156;412;7;405;13
906;ORCOYEN;1;1;B;477;139;338;7;331;13
907;ZIZUR MAYOR / ZIZUR NAGUSIA;1;1;U;873;273;600;7;593;9
907;ZIZUR MAYOR / ZIZUR NAGUSIA;1;2;A;477;173;304;0;304;9
907;ZIZUR MAYOR / ZIZUR NAGUSIA;1;2;B;534;197;337;5;332;10
907;ZIZUR MAYOR / ZIZUR NAGUSIA;1;3;A;539;208;331;3;328;8
907;ZIZUR MAYOR / ZIZUR NAGUSIA;1;3;B;607;231;376;5;371;5
907;ZIZUR MAYOR / ZIZUR NAGUSIA;1;3;C;502;206;296;0;296;11
907;ZIZUR MAYOR / ZIZUR NAGUSIA;1;4;A;606;253;353;2;351;3
907;ZIZUR MAYOR / ZIZUR NAGUSIA;1;4;B;642;240;402;1;401;12
907;ZIZUR MAYOR / ZIZUR NAGUSIA;1;4;C;537;200;337;1;336;15
907;ZIZUR MAYOR / ZIZUR NAGUSIA;1;5;A;1018;389;629;2;627;29
907;ZIZUR MAYOR / ZIZUR NAGUSIA;1;5;B;1010;381;629;3;626;14
908;LEKUNBERRI;1;1;U;666;183;483;1;482;7
